AAAAAAGCCTATCTCCGATC -> AAAAAGCCTATCTCCGATCT
AAAAAGCCTATCTCCGATCT -> AAAAGCCTATCTCCGATCTC
AAAAATCTTGCCCGAACCAT -> AAAATCTTGCCCGAACCATC
AAAAGCCTATCTCCGATCTC -> AAAGCCTATCTCCGATCTCG
AAAAGTAAACGTAGAGAAGT -> AAAGTAAACGTAGAGAAGTT
AAAATAGGTGGGTCGGTCAA -> AAATAGGTGGGTCGGTCAAA
AAAATCTTGCCCGAACCATC -> AAATCTTGCCCGAACCATCT
AAACCGATGCGCTCTGGACT -> AACCGATGCGCTCTGGACTG
AAACCGCTATATGCTCTTGG -> AACCGCTATATGCTCTTGGC
AAACGTAGAGAAGTTTTTAA -> AACGTAGAGAAGTTTTTAAG
AAACTGGCATATCGCCAACA -> AACTGGCATATCGCCAACAA
AAACTTAACATTCGGTGGTA -> AACTTAACATTCGGTGGTAC
AAACTTGGACGTCTCACACG -> AACTTGGACGTCTCACACGT
AAAGCCTATCTCCGATCTCG -> AAGCCTATCTCCGATCTCGG
AAAGCGCTGCCTGGAAAAAT -> AAGCGCTGCCTGGAAAAATC
AAAGTAAACGTAGAGAAGTT -> AAGTAAACGTAGAGAAGTTT
AAAGTCGCCTCATCAGCATT -> AAGTCGCCTCATCAGCATTG
AAATAGGTGGGTCGGTCAAA -> AATAGGTGGGTCGGTCAAAG
AAATCTTGCCCGAACCATCT -> AATCTTGCCCGAACCATCTG
AAATGCGGGTGCGACATGTG -> AATGCGGGTGCGACATGTGT
AAATGGGTCTCAGGAACTTG -> AATGGGTCTCAGGAACTTGT
AAATTAAAGCGCTGCCTGGA -> AATTAAAGCGCTGCCTGGAA
AACAAGGCATCCTCAAGCCT -> ACAAGGCATCCTCAAGCCTT
AACAATTCCACGGCCATGCC -> ACAATTCCACGGCCATGCCT
AACATTCGGTGGTACAGCAG -> ACATTCGGTGGTACAGCAGT
AACCATCTGCAAGGAAGGCT -> ACCATCTGCAAGGAAGGCTA
AACCGATGCGCTCTGGACTG -> ACCGATGCGCTCTGGACTGC
AACCGCTATATGCTCTTGGC -> ACCGCTATATGCTCTTGGCA
AACGATTAAACTGGCATATC -> ACGATTAAACTGGCATATCG
AACGCCCTTACACAGGGGGG -> ACGCCCTTACACAGGGGGGG
AACGTAAACTTGGACGTCTC -> ACGTAAACTTGGACGTCTCA
AACGTAGAGAAGTTTTTAAG -> ACGTAGAGAAGTTTTTAAGT
AACGTCGAGCACGATGCGTA -> ACGTCGAGCACGATGCGTAA
AACGTCTCCTGTTGCCAGTC -> ACGTCTCCTGTTGCCAGTCT
AACTCAAACCGCTATATGCT -> ACTCAAACCGCTATATGCTC
AACTGGCATATCGCCAACAA -> ACTGGCATATCGCCAACAAT
AACTTAACATTCGGTGGTAC -> ACTTAACATTCGGTGGTACA
AACTTGGACGTCTCACACGT -> ACTTGGACGTCTCACACGTT
AACTTGTGCTATGGGGCCAG -> ACTTGTGCTATGGGGCCAGG
AAGAATGGCTACACTTCAGG -> AGAATGGCTACACTTCAGGT
AAGCACCGACAAAAGTAAAC -> AGCACCGACAAAAGTAAACG
AAGCCTATCTCCGATCTCGG -> AGCCTATCTCCGATCTCGGA
AAGCCTTTATGTTCCATCAC -> AGCCTTTATGTTCCATCACA
AAGCGCTGCCTGGAAAAATC -> AGCGCTGCCTGGAAAAATCT
AAGGAAGGCTATAATCACCA -> AGGAAGGCTATAATCACCAT
AAGGCATCCTCAAGCCTTTA -> AGGCATCCTCAAGCCTTTAT
AAGGCGTTTCGGGGTCCGCG -> AGGCGTTTCGGGGTCCGCGG
AAGGCTATAATCACCATCCG -> AGGCTATAATCACCATCCGA
AAGTAAACGTAGAGAAGTTT -> AGTAAACGTAGAGAAGTTTT
AAGTCGCCTCATCAGCATTG -> AGTCGCCTCATCAGCATTGA
AAGTGAGATGAACGTCTCCT -> AGTGAGATGAACGTCTCCTG
AAGTTAGGTAATCCGCGCCA -> AGTTAGGTAATCCGCGCCAA
AAGTTTTTAAGTTAGGTAAT -> AGTTTTTAAGTTAGGTAATC
AATACGACGGTCTTAACTCA -> ATACGACGGTCTTAACTCAA
AATACTTCCTTGAGGGAAAT -> ATACTTCCTTGAGGGAAATT
AATAGGTGGGTCGGTCAAAG -> ATAGGTGGGTCGGTCAAAGT
AATAGTCCGTAAACCGATGC -> ATAGTCCGTAAACCGATGCG
AATCACCATCCGACGCCCGT -> ATCACCATCCGACGCCCGTC
AATCCGCGCCAATGGAACGC -> ATCCGCGCCAATGGAACGCC
AATCGTTGGCCGAGTGCGGA -> ATCGTTGGCCGAGTGCGGAA
AATCTATTTGGCGTCCAGGT -> ATCTATTTGGCGTCCAGGTC
AATCTGTTGAACAAGGCATC -> ATCTGTTGAACAAGGCATCC
AATCTTGCCCGAACCATCTG -> ATCTTGCCCGAACCATCTGC
AATGCGGGTGCGACATGTGT -> ATGCGGGTGCGACATGTGTC
AATGGAACGCCCTTACACAG -> ATGGAACGCCCTTACACAGG
AATGGCTACACTTCAGGTCT -> ATGGCTACACTTCAGGTCTT
AATGGGTCTCAGGAACTTGT -> ATGGGTCTCAGGAACTTGTG
AATTAAAGCGCTGCCTGGAA -> ATTAAAGCGCTGCCTGGAAA
AATTATAAAAAAGCCTATCT -> ATTATAAAAAAGCCTATCTC
AATTCCACGGCCATGCCTTA -> ATTCCACGGCCATGCCTTAC
ACAAAAGTAAACGTAGAGAA -> CAAAAGTAAACGTAGAGAAG
ACAAGGCATCCTCAAGCCTT -> CAAGGCATCCTCAAGCCTTT
ACAATTCCACGGCCATGCCT -> CAATTCCACGGCCATGCCTT
ACACAGGGGGGGCCCAGAGC -> CACAGGGGGGGCCCAGAGCG
ACACGTTATGCCGTGATTTC -> CACGTTATGCCGTGATTTCA
ACACTTCAGGTCTTGGTCCA -> CACTTCAGGTCTTGGTCCAT
ACAGCGCGAGGTAGTGTCCC -> CAGCGCGAGGTAGTGTCCCC
ACAGGCACTGAAGAATGGCT -> CAGGCACTGAAGAATGGCTA
ACAGGCCATATATGAAGGCG -> CAGGCCATATATGAAGGCGT
ACAGGGGGGGCCCAGAGCGA -> CAGGGGGGGCCCAGAGCGAC
ACATCGACCGCTGCCGAATC -> CATCGACCGCTGCCGAATCT
ACATGTGTCTGAGTTTCCTC -> CATGTGTCTGAGTTTCCTCT
ACATTCGGTGGTACAGCAGT -> CATTCGGTGGTACAGCAGTT
ACATTGGCTATGGAGTAACG -> CATTGGCTATGGAGTAACGT
ACCATCCGACGCCCGTCGGT -> CCATCCGACGCCCGTCGGTC
ACCATCTGCAAGGAAGGCTA -> CCATCTGCAAGGAAGGCTAT
ACCGACAAAAGTAAACGTAG -> CCGACAAAAGTAAACGTAGA
ACCGATGCGCTCTGGACTGC -> CCGATGCGCTCTGGACTGCA
ACCGCTATATGCTCTTGGCA -> CCGCTATATGCTCTTGGCAG
ACCGCTGCCGAATCTGTTGA -> CCGCTGCCGAATCTGTTGAA
ACCTAACGTCGAGCACGATG -> CCTAACGTCGAGCACGATGC
ACGACGGTCTTAACTCAAAC -> CGACGGTCTTAACTCAAACC
ACGATGCGTAACGATTAAAC -> CGATGCGTAACGATTAAACT
ACGATGGGTCATTTTCTAAA -> CGATGGGTCATTTTCTAAAT
ACGATTAAACTGGCATATCG -> CGATTAAACTGGCATATCGC
ACGCAAGCACCGACAAAAGT -> CGCAAGCACCGACAAAAGTA
ACGCCCCGGATTCTTAGTTC -> CGCCCCGGATTCTTAGTTCA
ACGCCCGTCGGTCACGATGG -> CGCCCGTCGGTCACGATGGG
ACGCCCTTACACAGGGGGGG -> CGCCCTTACACAGGGGGGGC
ACGCGTTCGCGCCAATAGTC -> CGCGTTCGCGCCAATAGTCC
ACGGAGTTGGATTCCGGTCA -> CGGAGTTGGATTCCGGTCAA
ACGGCCATGCCTTACAGCGC -> CGGCCATGCCTTACAGCGCG
ACGGCCCTAGAAACTTAACA -> CGGCCCTAGAAACTTAACAT
ACGGTCTTAACTCAAACCGC -> CGGTCTTAACTCAAACCGCT
ACGTAAACTTGGACGTCTCA -> CGTAAACTTGGACGTCTCAC
ACGTAGAGAAGTTTTTAAGT -> CGTAGAGAAGTTTTTAAGTT
ACGTCGAGCACGATGCGTAA -> CGTCGAGCACGATGCGTAAC
ACGTCTCACACGTTATGCCG -> CGTCTCACACGTTATGCCGT
ACGTCTCCTGTTGCCAGTCT -> CGTCTCCTGTTGCCAGTCTG
ACGTTATGCCGTGATTTCAC -> CGTTATGCCGTGATTTCACG
ACTCAAACCGCTATATGCTC -> CTCAAACCGCTATATGCTCT
ACTGAAGAATGGCTACACTT -> CTGAAGAATGGCTACACTTC
ACTGCAGTTCAAGTGAGATG -> CTGCAGTTCAAGTGAGATGA
ACTGGCATATCGCCAACAAT -> CTGGCATATCGCCAACAATT
ACTTAACATTCGGTGGTACA -> CTTAACATTCGGTGGTACAG
ACTTCAGGTCTTGGTCCATT -> CTTCAGGTCTTGGTCCATTG
ACTTCCTTGAGGGAAATTAA -> CTTCCTTGAGGGAAATTAAA
ACTTGGACGTCTCACACGTT -> CTTGGACGTCTCACACGTTA
ACTTGTGCTATGGGGCCAGG -> CTTGTGCTATGGGGCCAGGG
AGAAACTTAACATTCGGTGG -> GAAACTTAACATTCGGTGGT
AGAAGTTTTTAAGTTAGGTA -> GAAGTTTTTAAGTTAGGTAA
AGAATCGTTGGCCGAGTGCG -> GAATCGTTGGCCGAGTGCGG
AGAATGGCTACACTTCAGGT -> GAATGGCTACACTTCAGGTC
AGAGAAGTTTTTAAGTTAGG -> GAGAAGTTTTTAAGTTAGGT
AGAGCGACAGGCACTGAAGA -> GAGCGACAGGCACTGAAGAA
AGATGAACGTCTCCTGTTGC -> GATGAACGTCTCCTGTTGCC
AGCACCGACAAAAGTAAACG -> GCACCGACAAAAGTAAACGT
AGCACGATGCGTAACGATTA -> GCACGATGCGTAACGATTAA
AGCATTGATCACGCAAGCAC -> GCATTGATCACGCAAGCACC
AGCCTATCTCCGATCTCGGA -> GCCTATCTCCGATCTCGGAT
AGCCTTTATGTTCCATCACA -> GCCTTTATGTTCCATCACAT
AGCGACAGGCACTGAAGAAT -> GCGACAGGCACTGAAGAATG
AGCGCGAGGTAGTGTCCCCG -> GCGCGAGGTAGTGTCCCCGG
AGCGCTACGGAGTTGGATTC -> GCGCTACGGAGTTGGATTCC
AGCGCTGCCTGGAAAAATCT -> GCGCTGCCTGGAAAAATCTT
AGCTCGTGCTCTGGGCCGCG -> GCTCGTGCTCTGGGCCGCGC
AGGAACTTGTGCTATGGGGC -> GGAACTTGTGCTATGGGGCC
AGGAAGGCTATAATCACCAT -> GGAAGGCTATAATCACCATC
AGGCACTGAAGAATGGCTAC -> GGCACTGAAGAATGGCTACA
AGGCATCCTCAAGCCTTTAT -> GGCATCCTCAAGCCTTTATG
AGGCCATATATGAAGGCGTT -> GGCCATATATGAAGGCGTTT
AGGCGCTGGCAGGTTGGACA -> GGCGCTGGCAGGTTGGACAG
AGGCGTTTCGGGGTCCGCGG -> GGCGTTTCGGGGTCCGCGGC
AGGCTATAATCACCATCCGA -> GGCTATAATCACCATCCGAC
AGGGAAATTAAAGCGCTGCC -> GGGAAATTAAAGCGCTGCCT
AGGGAATACGACGGTCTTAA -> GGGAATACGACGGTCTTAAC
AGGGGGGGCCCAGAGCGACA -> GGGGGGGCCCAGAGCGACAG
AGGTAATCCGCGCCAATGGA -> GGTAATCCGCGCCAATGGAA
AGGTAGTGTCCCCGGCACGC -> GGTAGTGTCCCCGGCACGCC
AGGTCAAAATAGGTGGGTCG -> GGTCAAAATAGGTGGGTCGG
AGGTCTTGGTCCATTGGACA -> GGTCTTGGTCCATTGGACAT
AGGTGGCCAGTTCGCGCCCC -> GGTGGCCAGTTCGCGCCCCC
AGGTGGGTCGGTCAAAGTCG -> GGTGGGTCGGTCAAAGTCGC
AGGTTGGACAGGCCATATAT -> GGTTGGACAGGCCATATATG
AGTAAACGTAGAGAAGTTTT -> GTAAACGTAGAGAAGTTTTT
AGTAACGTAAACTTGGACGT -> GTAACGTAAACTTGGACGTC
AGTCCGTAAACCGATGCGCT -> GTCCGTAAACCGATGCGCTC
AGTCGCCTCATCAGCATTGA -> GTCGCCTCATCAGCATTGAT
AGTCTGGTGTAGGTGGCCAG -> GTCTGGTGTAGGTGGCCAGT
AGTGAGATGAACGTCTCCTG -> GTGAGATGAACGTCTCCTGT
AGTGCGGAATTATAAAAAAG -> GTGCGGAATTATAAAAAAGC
AGTGTCCCCGGCACGCCCCG -> GTGTCCCCGGCACGCCCCGG
AGTTAGGTAATCCGCGCCAA -> GTTAGGTAATCCGCGCCAAT
AGTTCAAATGCGGGTGCGAC -> GTTCAAATGCGGGTGCGACA
AGTTCAAGTGAGATGAACGT -> GTTCAAGTGAGATGAACGTC
AGTTCGCGCCCCCATCCGTG -> GTTCGCGCCCCCATCCGTGT
AGTTGGATTCCGGTCAATCT -> GTTGGATTCCGGTCAATCTA
AGTTTCCTCTGGGAGCGCTA -> GTTTCCTCTGGGAGCGCTAC
AGTTTTTAAGTTAGGTAATC -> GTTTTTAAGTTAGGTAATCC
ATAAAAAAGCCTATCTCCGA -> TAAAAAAGCCTATCTCCGAT
ATAATCACCATCCGACGCCC -> TAATCACCATCCGACGCCCG
ATACGACGGTCTTAACTCAA -> TACGACGGTCTTAACTCAAA
ATACTTCCTTGAGGGAAATT -> TACTTCCTTGAGGGAAATTA
ATAGGCGCTGGCAGGTTGGA -> TAGGCGCTGGCAGGTTGGAC
ATAGGTGGGTCGGTCAAAGT -> TAGGTGGGTCGGTCAAAGTC
ATAGTCCGTAAACCGATGCG -> TAGTCCGTAAACCGATGCGC
ATATATGAAGGCGTTTCGGG -> TATATGAAGGCGTTTCGGGG
ATATCGCCAACAATTCCACG -> TATCGCCAACAATTCCACGG
ATATGAAGGCGTTTCGGGGT -> TATGAAGGCGTTTCGGGGTC
ATATGCTCTTGGCAGAATCG -> TATGCTCTTGGCAGAATCGT
ATCACATTGGCTATGGAGTA -> TCACATTGGCTATGGAGTAA
ATCACCATCCGACGCCCGTC -> TCACCATCCGACGCCCGTCG
ATCACGCAAGCACCGACAAA -> TCACGCAAGCACCGACAAAA
ATCAGCATTGATCACGCAAG -> TCAGCATTGATCACGCAAGC
ATCCCCGCACCTAACGTCGA -> TCCCCGCACCTAACGTCGAG
ATCCGACGCCCGTCGGTCAC -> TCCGACGCCCGTCGGTCACG
ATCCGCGCCAATGGAACGCC -> TCCGCGCCAATGGAACGCCC
ATCCGTGTTGTGGATCCCCG -> TCCGTGTTGTGGATCCCCGC
ATCCTCAAGCCTTTATGTTC -> TCCTCAAGCCTTTATGTTCC
ATCGACCGCTGCCGAATCTG -> TCGACCGCTGCCGAATCTGT
ATCGCCAACAATTCCACGGC -> TCGCCAACAATTCCACGGCC
ATCGTTGGCCGAGTGCGGAA -> TCGTTGGCCGAGTGCGGAAT
ATCTATTTGGCGTCCAGGTC -> TCTATTTGGCGTCCAGGTCA
ATCTCCGATCTCGGATTGTC -> TCTCCGATCTCGGATTGTCC
ATCTCGGATTGTCCCAGCTC -> TCTCGGATTGTCCCAGCTCG
ATCTGCAAGGAAGGCTATAA -> TCTGCAAGGAAGGCTATAAT
ATCTGTTGAACAAGGCATCC -> TCTGTTGAACAAGGCATCCT
ATCTTGCCCGAACCATCTGC -> TCTTGCCCGAACCATCTGCA
ATGAACGTCTCCTGTTGCCA -> TGAACGTCTCCTGTTGCCAG
ATGAAGGCGTTTCGGGGTCC -> TGAAGGCGTTTCGGGGTCCG
ATGCCGTGATTTCACGGCCC -> TGCCGTGATTTCACGGCCCT
ATGCCTTACAGCGCGAGGTA -> TGCCTTACAGCGCGAGGTAG
ATGCGCTCTGGACTGCAGTT -> TGCGCTCTGGACTGCAGTTC
ATGCGGGTGCGACATGTGTC -> TGCGGGTGCGACATGTGTCT
ATGCGTAACGATTAAACTGG -> TGCGTAACGATTAAACTGGC
ATGCTCTTGGCAGAATCGTT -> TGCTCTTGGCAGAATCGTTG
ATGGAACGCCCTTACACAGG -> TGGAACGCCCTTACACAGGG
ATGGAGTAACGTAAACTTGG -> TGGAGTAACGTAAACTTGGA
ATGGCTACACTTCAGGTCTT -> TGGCTACACTTCAGGTCTTG
ATGGGGCCAGGGAATACGAC -> TGGGGCCAGGGAATACGACG
ATGGGTCATTTTCTAAATGG -> TGGGTCATTTTCTAAATGGG
ATGGGTCTCAGGAACTTGTG -> TGGGTCTCAGGAACTTGTGC
ATGTGTCTGAGTTTCCTCTG -> TGTGTCTGAGTTTCCTCTGG
ATGTTCCATCACATTGGCTA -> TGTTCCATCACATTGGCTAT
ATTAAACTGGCATATCGCCA -> TTAAACTGGCATATCGCCAA
ATTAAAGCGCTGCCTGGAAA -> TTAAAGCGCTGCCTGGAAAA
ATTATAAAAAAGCCTATCTC -> TTATAAAAAAGCCTATCTCC
ATTCCACGGCCATGCCTTAC -> TTCCACGGCCATGCCTTACA
ATTCCGGTCAATCTATTTGG -> TTCCGGTCAATCTATTTGGC
ATTCGGTGGTACAGCAGTTA -> TTCGGTGGTACAGCAGTTAT
ATTCTTAGTTCAAATGCGGG -> TTCTTAGTTCAAATGCGGGT
ATTGATCACGCAAGCACCGA -> TTGATCACGCAAGCACCGAC
ATTGGACATCGACCGCTGCC -> TTGGACATCGACCGCTGCCG
ATTGGCTATGGAGTAACGTA -> TTGGCTATGGAGTAACGTAA
ATTGTCCCAGCTCGTGCTCT -> TTGTCCCAGCTCGTGCTCTG
ATTTCACGGCCCTAGAAACT -> TTTCACGGCCCTAGAAACTT
ATTTGGCGTCCAGGTCAAAA -> TTTGGCGTCCAGGTCAAAAT
ATTTTCTAAATGGGTCTCAG -> TTTTCTAAATGGGTCTCAGG
CAAAAGTAAACGTAGAGAAG -> AAAAGTAAACGTAGAGAAGT
CAAAATAGGTGGGTCGGTCA -> AAAATAGGTGGGTCGGTCAA
CAAACCGCTATATGCTCTTG -> AAACCGCTATATGCTCTTGG
CAAAGTCGCCTCATCAGCAT -> AAAGTCGCCTCATCAGCATT
CAAATGCGGGTGCGACATGT -> AAATGCGGGTGCGACATGTG
CAACAATTCCACGGCCATGC -> AACAATTCCACGGCCATGCC
CAAGCACCGACAAAAGTAAA -> AAGCACCGACAAAAGTAAAC
CAAGCCTTTATGTTCCATCA -> AAGCCTTTATGTTCCATCAC
CAAGGAAGGCTATAATCACC -> AAGGAAGGCTATAATCACCA
CAAGGCATCCTCAAGCCTTT -> AAGGCATCCTCAAGCCTTTA
CAAGTGAGATGAACGTCTCC -> AAGTGAGATGAACGTCTCCT
CAATACTTCCTTGAGGGAAA -> AATACTTCCTTGAGGGAAAT
CAATAGTCCGTAAACCGATG -> AATAGTCCGTAAACCGATGC
CAATCTATTTGGCGTCCAGG -> AATCTATTTGGCGTCCAGGT
CAATGGAACGCCCTTACACA -> AATGGAACGCCCTTACACAG
CAATTCCACGGCCATGCCTT -> AATTCCACGGCCATGCCTTA
CACACGTTATGCCGTGATTT -> ACACGTTATGCCGTGATTTC
CACAGGGGGGGCCCAGAGCG -> ACAGGGGGGGCCCAGAGCGA
CACATTGGCTATGGAGTAAC -> ACATTGGCTATGGAGTAACG
CACCATCCGACGCCCGTCGG -> ACCATCCGACGCCCGTCGGT
CACCGACAAAAGTAAACGTA -> ACCGACAAAAGTAAACGTAG
CACCTAACGTCGAGCACGAT -> ACCTAACGTCGAGCACGATG
CACGATGCGTAACGATTAAA -> ACGATGCGTAACGATTAAAC
CACGATGGGTCATTTTCTAA -> ACGATGGGTCATTTTCTAAA
CACGCAAGCACCGACAAAAG -> ACGCAAGCACCGACAAAAGT
CACGCCCCGGATTCTTAGTT -> ACGCCCCGGATTCTTAGTTC
CACGGCCATGCCTTACAGCG -> ACGGCCATGCCTTACAGCGC
CACGGCCCTAGAAACTTAAC -> ACGGCCCTAGAAACTTAACA
CACGTTATGCCGTGATTTCA -> ACGTTATGCCGTGATTTCAC
CACTGAAGAATGGCTACACT -> ACTGAAGAATGGCTACACTT
CACTTCAGGTCTTGGTCCAT -> ACTTCAGGTCTTGGTCCATT
CAGAATCGTTGGCCGAGTGC -> AGAATCGTTGGCCGAGTGCG
CAGAGCGACAGGCACTGAAG -> AGAGCGACAGGCACTGAAGA
CAGCATTGATCACGCAAGCA -> AGCATTGATCACGCAAGCAC
CAGCGCGAGGTAGTGTCCCC -> AGCGCGAGGTAGTGTCCCCG
CAGCTCGTGCTCTGGGCCGC -> AGCTCGTGCTCTGGGCCGCG
CAGGAACTTGTGCTATGGGG -> AGGAACTTGTGCTATGGGGC
CAGGCACTGAAGAATGGCTA -> AGGCACTGAAGAATGGCTAC
CAGGCCATATATGAAGGCGT -> AGGCCATATATGAAGGCGTT
CAGGGAATACGACGGTCTTA -> AGGGAATACGACGGTCTTAA
CAGGGGGGGCCCAGAGCGAC -> AGGGGGGGCCCAGAGCGACA
CAGGTCAAAATAGGTGGGTC -> AGGTCAAAATAGGTGGGTCG
CAGGTCTTGGTCCATTGGAC -> AGGTCTTGGTCCATTGGACA
CAGGTTGGACAGGCCATATA -> AGGTTGGACAGGCCATATAT
CAGTCTGGTGTAGGTGGCCA -> AGTCTGGTGTAGGTGGCCAG
CAGTTCAAGTGAGATGAACG -> AGTTCAAGTGAGATGAACGT
CAGTTCGCGCCCCCATCCGT -> AGTTCGCGCCCCCATCCGTG
CATAGGCGCTGGCAGGTTGG -> ATAGGCGCTGGCAGGTTGGA
CATATATGAAGGCGTTTCGG -> ATATATGAAGGCGTTTCGGG
CATATCGCCAACAATTCCAC -> ATATCGCCAACAATTCCACG
CATCACATTGGCTATGGAGT -> ATCACATTGGCTATGGAGTA
CATCAGCATTGATCACGCAA -> ATCAGCATTGATCACGCAAG
CATCCGACGCCCGTCGGTCA -> ATCCGACGCCCGTCGGTCAC
CATCCGTGTTGTGGATCCCC -> ATCCGTGTTGTGGATCCCCG
CATCCTCAAGCCTTTATGTT -> ATCCTCAAGCCTTTATGTTC
CATCGACCGCTGCCGAATCT -> ATCGACCGCTGCCGAATCTG
CATCTGCAAGGAAGGCTATA -> ATCTGCAAGGAAGGCTATAA
CATGCCTTACAGCGCGAGGT -> ATGCCTTACAGCGCGAGGTA
CATGTGTCTGAGTTTCCTCT -> ATGTGTCTGAGTTTCCTCTG
CATTCGGTGGTACAGCAGTT -> ATTCGGTGGTACAGCAGTTA
CATTGATCACGCAAGCACCG -> ATTGATCACGCAAGCACCGA
CATTGGACATCGACCGCTGC -> ATTGGACATCGACCGCTGCC
CATTGGCTATGGAGTAACGT -> ATTGGCTATGGAGTAACGTA
CATTTTCTAAATGGGTCTCA -> ATTTTCTAAATGGGTCTCAG
CCAACAATTCCACGGCCATG -> CAACAATTCCACGGCCATGC
CCAATACTTCCTTGAGGGAA -> CAATACTTCCTTGAGGGAAA
CCAATAGTCCGTAAACCGAT -> CAATAGTCCGTAAACCGATG
CCAATGGAACGCCCTTACAC -> CAATGGAACGCCCTTACACA
CCACGGCCATGCCTTACAGC -> CACGGCCATGCCTTACAGCG
CCAGAGCGACAGGCACTGAA -> CAGAGCGACAGGCACTGAAG
CCAGCTCGTGCTCTGGGCCG -> CAGCTCGTGCTCTGGGCCGC
CCAGGGAATACGACGGTCTT -> CAGGGAATACGACGGTCTTA
CCAGGTCAAAATAGGTGGGT -> CAGGTCAAAATAGGTGGGTC
CCAGTCTGGTGTAGGTGGCC -> CAGTCTGGTGTAGGTGGCCA
CCAGTTCGCGCCCCCATCCG -> CAGTTCGCGCCCCCATCCGT
CCATATATGAAGGCGTTTCG -> CATATATGAAGGCGTTTCGG
CCATCACATTGGCTATGGAG -> CATCACATTGGCTATGGAGT
CCATCCGACGCCCGTCGGTC -> CATCCGACGCCCGTCGGTCA
CCATCCGTGTTGTGGATCCC -> CATCCGTGTTGTGGATCCCC
CCATCTGCAAGGAAGGCTAT -> CATCTGCAAGGAAGGCTATA
CCATGCCTTACAGCGCGAGG -> CATGCCTTACAGCGCGAGGT
CCATTGGACATCGACCGCTG -> CATTGGACATCGACCGCTGC
CCCAATACTTCCTTGAGGGA -> CCAATACTTCCTTGAGGGAA
CCCAGAGCGACAGGCACTGA -> CCAGAGCGACAGGCACTGAA
CCCAGCTCGTGCTCTGGGCC -> CCAGCTCGTGCTCTGGGCCG
CCCATCCGTGTTGTGGATCC -> CCATCCGTGTTGTGGATCCC
CCCCATCCGTGTTGTGGATC -> CCCATCCGTGTTGTGGATCC
CCCCCATCCGTGTTGTGGAT -> CCCCATCCGTGTTGTGGATC
CCCCGCACCTAACGTCGAGC -> CCCGCACCTAACGTCGAGCA
CCCCGGATTCTTAGTTCAAA -> CCCGGATTCTTAGTTCAAAT
CCCCGGCACGCCCCGGATTC -> CCCGGCACGCCCCGGATTCT
CCCGAACCATCTGCAAGGAA -> CCGAACCATCTGCAAGGAAG
CCCGCACCTAACGTCGAGCA -> CCGCACCTAACGTCGAGCAC
CCCGGATTCTTAGTTCAAAT -> CCGGATTCTTAGTTCAAATG
CCCGGCACGCCCCGGATTCT -> CCGGCACGCCCCGGATTCTT
CCCGTCGGTCACGATGGGTC -> CCGTCGGTCACGATGGGTCA
CCCTAGAAACTTAACATTCG -> CCTAGAAACTTAACATTCGG
CCCTTACACAGGGGGGGCCC -> CCTTACACAGGGGGGGCCCA
CCGAACCATCTGCAAGGAAG -> CGAACCATCTGCAAGGAAGG
CCGAATCTGTTGAACAAGGC -> CGAATCTGTTGAACAAGGCA
CCGACAAAAGTAAACGTAGA -> CGACAAAAGTAAACGTAGAG
CCGACGCCCGTCGGTCACGA -> CGACGCCCGTCGGTCACGAT
CCGAGTGCGGAATTATAAAA -> CGAGTGCGGAATTATAAAAA
CCGATCTCGGATTGTCCCAG -> CGATCTCGGATTGTCCCAGC
CCGATGCGCTCTGGACTGCA -> CGATGCGCTCTGGACTGCAG
CCGCACCTAACGTCGAGCAC -> CGCACCTAACGTCGAGCACG
CCGCGCATAGGCGCTGGCAG -> CGCGCATAGGCGCTGGCAGG
CCGCGCCAATGGAACGCCCT -> CGCGCCAATGGAACGCCCTT
CCGCGGCCTACGCGTTCGCG -> CGCGGCCTACGCGTTCGCGC
CCGCTATATGCTCTTGGCAG -> CGCTATATGCTCTTGGCAGA
CCGCTGCCGAATCTGTTGAA -> CGCTGCCGAATCTGTTGAAC
CCGGATTCTTAGTTCAAATG -> CGGATTCTTAGTTCAAATGC
CCGGCACGCCCCGGATTCTT -> CGGCACGCCCCGGATTCTTA
CCGGTCAATCTATTTGGCGT -> CGGTCAATCTATTTGGCGTC
CCGTAAACCGATGCGCTCTG -> CGTAAACCGATGCGCTCTGG
CCGTCGGTCACGATGGGTCA -> CGTCGGTCACGATGGGTCAT
CCGTGATTTCACGGCCCTAG -> CGTGATTTCACGGCCCTAGA
CCGTGTTGTGGATCCCCGCA -> CGTGTTGTGGATCCCCGCAC
CCTAACGTCGAGCACGATGC -> CTAACGTCGAGCACGATGCG
CCTACGCGTTCGCGCCAATA -> CTACGCGTTCGCGCCAATAG
CCTAGAAACTTAACATTCGG -> CTAGAAACTTAACATTCGGT
CCTATCTCCGATCTCGGATT -> CTATCTCCGATCTCGGATTG
CCTCAAGCCTTTATGTTCCA -> CTCAAGCCTTTATGTTCCAT
CCTCATCAGCATTGATCACG -> CTCATCAGCATTGATCACGC
CCTCTGGGAGCGCTACGGAG -> CTCTGGGAGCGCTACGGAGT
CCTGGAAAAATCTTGCCCGA -> CTGGAAAAATCTTGCCCGAA
CCTGTTGCCAGTCTGGTGTA -> CTGTTGCCAGTCTGGTGTAG
CCTTACACAGGGGGGGCCCA -> CTTACACAGGGGGGGCCCAG
CCTTACAGCGCGAGGTAGTG -> CTTACAGCGCGAGGTAGTGT
CCTTGAGGGAAATTAAAGCG -> CTTGAGGGAAATTAAAGCGC
CCTTTATGTTCCATCACATT -> CTTTATGTTCCATCACATTG
CGAACCATCTGCAAGGAAGG -> GAACCATCTGCAAGGAAGGC
CGAATCTGTTGAACAAGGCA -> GAATCTGTTGAACAAGGCAT
CGACAAAAGTAAACGTAGAG -> GACAAAAGTAAACGTAGAGA
CGACAGGCACTGAAGAATGG -> GACAGGCACTGAAGAATGGC
CGACATGTGTCTGAGTTTCC -> GACATGTGTCTGAGTTTCCT
CGACCGCTGCCGAATCTGTT -> GACCGCTGCCGAATCTGTTG
CGACGCCCGTCGGTCACGAT -> GACGCCCGTCGGTCACGATG
CGACGGTCTTAACTCAAACC -> GACGGTCTTAACTCAAACCG
CGAGCACGATGCGTAACGAT -> GAGCACGATGCGTAACGATT
CGAGGTAGTGTCCCCGGCAC -> GAGGTAGTGTCCCCGGCACG
CGAGTGCGGAATTATAAAAA -> GAGTGCGGAATTATAAAAAA
CGATCTCGGATTGTCCCAGC -> GATCTCGGATTGTCCCAGCT
CGATGCGCTCTGGACTGCAG -> GATGCGCTCTGGACTGCAGT
CGATGCGTAACGATTAAACT -> GATGCGTAACGATTAAACTG
CGATGGGTCATTTTCTAAAT -> GATGGGTCATTTTCTAAATG
CGATTAAACTGGCATATCGC -> GATTAAACTGGCATATCGCC
CGCAAGCACCGACAAAAGTA -> GCAAGCACCGACAAAAGTAA
CGCACCTAACGTCGAGCACG -> GCACCTAACGTCGAGCACGA
CGCATAGGCGCTGGCAGGTT -> GCATAGGCGCTGGCAGGTTG
CGCCAACAATTCCACGGCCA -> GCCAACAATTCCACGGCCAT
CGCCAATAGTCCGTAAACCG -> GCCAATAGTCCGTAAACCGA
CGCCAATGGAACGCCCTTAC -> GCCAATGGAACGCCCTTACA
CGCCCCCATCCGTGTTGTGG -> GCCCCCATCCGTGTTGTGGA
CGCCCCGGATTCTTAGTTCA -> GCCCCGGATTCTTAGTTCAA
CGCCCGTCGGTCACGATGGG -> GCCCGTCGGTCACGATGGGT
CGCCCTTACACAGGGGGGGC -> GCCCTTACACAGGGGGGGCC
CGCCTCATCAGCATTGATCA -> GCCTCATCAGCATTGATCAC
CGCGAGGTAGTGTCCCCGGC -> GCGAGGTAGTGTCCCCGGCA
CGCGCATAGGCGCTGGCAGG -> GCGCATAGGCGCTGGCAGGT
CGCGCCAATAGTCCGTAAAC -> GCGCCAATAGTCCGTAAACC
CGCGCCAATGGAACGCCCTT -> GCGCCAATGGAACGCCCTTA
CGCGCCCCCATCCGTGTTGT -> GCGCCCCCATCCGTGTTGTG
CGCGGCCTACGCGTTCGCGC -> GCGGCCTACGCGTTCGCGCC
CGCGTTCGCGCCAATAGTCC -> GCGTTCGCGCCAATAGTCCG
CGCTACGGAGTTGGATTCCG -> GCTACGGAGTTGGATTCCGG
CGCTATATGCTCTTGGCAGA -> GCTATATGCTCTTGGCAGAA
CGCTCTGGACTGCAGTTCAA -> GCTCTGGACTGCAGTTCAAG
CGCTGCCGAATCTGTTGAAC -> GCTGCCGAATCTGTTGAACA
CGCTGCCTGGAAAAATCTTG -> GCTGCCTGGAAAAATCTTGC
CGCTGGCAGGTTGGACAGGC -> GCTGGCAGGTTGGACAGGCC
CGGAATTATAAAAAAGCCTA -> GGAATTATAAAAAAGCCTAT
CGGAGTTGGATTCCGGTCAA -> GGAGTTGGATTCCGGTCAAT
CGGATTCTTAGTTCAAATGC -> GGATTCTTAGTTCAAATGCG
CGGATTGTCCCAGCTCGTGC -> GGATTGTCCCAGCTCGTGCT
CGGCACGCCCCGGATTCTTA -> GGCACGCCCCGGATTCTTAG
CGGCCATGCCTTACAGCGCG -> GGCCATGCCTTACAGCGCGA
CGGCCCTAGAAACTTAACAT -> GGCCCTAGAAACTTAACATT
CGGCCTACGCGTTCGCGCCA -> GGCCTACGCGTTCGCGCCAA
CGGGGTCCGCGGCCTACGCG -> GGGGTCCGCGGCCTACGCGT
CGGGTGCGACATGTGTCTGA -> GGGTGCGACATGTGTCTGAG
CGGTCAAAGTCGCCTCATCA -> GGTCAAAGTCGCCTCATCAG
CGGTCAATCTATTTGGCGTC -> GGTCAATCTATTTGGCGTCC
CGGTCACGATGGGTCATTTT -> GGTCACGATGGGTCATTTTC
CGGTCTTAACTCAAACCGCT -> GGTCTTAACTCAAACCGCTA
CGGTGGTACAGCAGTTATAG -> GGTGGTACAGCAGTTATAGT
CGTAAACCGATGCGCTCTGG -> GTAAACCGATGCGCTCTGGA
CGTAAACTTGGACGTCTCAC -> GTAAACTTGGACGTCTCACA
CGTAACGATTAAACTGGCAT -> GTAACGATTAAACTGGCATA
CGTAGAGAAGTTTTTAAGTT -> GTAGAGAAGTTTTTAAGTTA
CGTCCAGGTCAAAATAGGTG -> GTCCAGGTCAAAATAGGTGG
CGTCGAGCACGATGCGTAAC -> GTCGAGCACGATGCGTAACG
CGTCGGTCACGATGGGTCAT -> GTCGGTCACGATGGGTCATT
CGTCTCACACGTTATGCCGT -> GTCTCACACGTTATGCCGTG
CGTCTCCTGTTGCCAGTCTG -> GTCTCCTGTTGCCAGTCTGG
CGTGATTTCACGGCCCTAGA -> GTGATTTCACGGCCCTAGAA
CGTGCTCTGGGCCGCGCATA -> GTGCTCTGGGCCGCGCATAG
CGTGTTGTGGATCCCCGCAC -> GTGTTGTGGATCCCCGCACC
CGTTATGCCGTGATTTCACG -> GTTATGCCGTGATTTCACGG
CGTTCGCGCCAATAGTCCGT -> GTTCGCGCCAATAGTCCGTA
CGTTGGCCGAGTGCGGAATT -> GTTGGCCGAGTGCGGAATTA
CGTTTCGGGGTCCGCGGCCT -> GTTTCGGGGTCCGCGGCCTA
CTAAATGGGTCTCAGGAACT -> TAAATGGGTCTCAGGAACTT
CTAACGTCGAGCACGATGCG -> TAACGTCGAGCACGATGCGT
CTACACTTCAGGTCTTGGTC -> TACACTTCAGGTCTTGGTCC
CTACGCGTTCGCGCCAATAG -> TACGCGTTCGCGCCAATAGT
CTACGGAGTTGGATTCCGGT -> TACGGAGTTGGATTCCGGTC
CTAGAAACTTAACATTCGGT -> TAGAAACTTAACATTCGGTG
CTATAATCACCATCCGACGC -> TATAATCACCATCCGACGCC
CTATATGCTCTTGGCAGAAT -> TATATGCTCTTGGCAGAATC
CTATCTCCGATCTCGGATTG -> TATCTCCGATCTCGGATTGT
CTATGGAGTAACGTAAACTT -> TATGGAGTAACGTAAACTTG
CTATGGGGCCAGGGAATACG -> TATGGGGCCAGGGAATACGA
CTATTTGGCGTCCAGGTCAA -> TATTTGGCGTCCAGGTCAAA
CTCAAACCGCTATATGCTCT -> TCAAACCGCTATATGCTCTT
CTCAAGCCTTTATGTTCCAT -> TCAAGCCTTTATGTTCCATC
CTCACACGTTATGCCGTGAT -> TCACACGTTATGCCGTGATT
CTCAGGAACTTGTGCTATGG -> TCAGGAACTTGTGCTATGGG
CTCATCAGCATTGATCACGC -> TCATCAGCATTGATCACGCA
CTCCGATCTCGGATTGTCCC -> TCCGATCTCGGATTGTCCCA
CTCCTGTTGCCAGTCTGGTG -> TCCTGTTGCCAGTCTGGTGT
CTCGGATTGTCCCAGCTCGT -> TCGGATTGTCCCAGCTCGTG
CTCGTGCTCTGGGCCGCGCA -> TCGTGCTCTGGGCCGCGCAT
CTCTGGACTGCAGTTCAAGT -> TCTGGACTGCAGTTCAAGTG
CTCTGGGAGCGCTACGGAGT -> TCTGGGAGCGCTACGGAGTT
CTCTGGGCCGCGCATAGGCG -> TCTGGGCCGCGCATAGGCGC
CTCTTGGCAGAATCGTTGGC -> TCTTGGCAGAATCGTTGGCC
CTGAAGAATGGCTACACTTC -> TGAAGAATGGCTACACTTCA
CTGAGTTTCCTCTGGGAGCG -> TGAGTTTCCTCTGGGAGCGC
CTGCAAGGAAGGCTATAATC -> TGCAAGGAAGGCTATAATCA
CTGCAGTTCAAGTGAGATGA -> TGCAGTTCAAGTGAGATGAA
CTGCCGAATCTGTTGAACAA -> TGCCGAATCTGTTGAACAAG
CTGCCTGGAAAAATCTTGCC -> TGCCTGGAAAAATCTTGCCC
CTGGAAAAATCTTGCCCGAA -> TGGAAAAATCTTGCCCGAAC
CTGGACTGCAGTTCAAGTGA -> TGGACTGCAGTTCAAGTGAG
CTGGCAGGTTGGACAGGCCA -> TGGCAGGTTGGACAGGCCAT
CTGGCATATCGCCAACAATT -> TGGCATATCGCCAACAATTC
CTGGGAGCGCTACGGAGTTG -> TGGGAGCGCTACGGAGTTGG
CTGGGCCGCGCATAGGCGCT -> TGGGCCGCGCATAGGCGCTG
CTGGTGTAGGTGGCCAGTTC -> TGGTGTAGGTGGCCAGTTCG
CTGTTGAACAAGGCATCCTC -> TGTTGAACAAGGCATCCTCA
CTGTTGCCAGTCTGGTGTAG -> TGTTGCCAGTCTGGTGTAGG
CTTAACATTCGGTGGTACAG -> TTAACATTCGGTGGTACAGC
CTTAACTCAAACCGCTATAT -> TTAACTCAAACCGCTATATG
CTTACACAGGGGGGGCCCAG -> TTACACAGGGGGGGCCCAGA
CTTACAGCGCGAGGTAGTGT -> TTACAGCGCGAGGTAGTGTC
CTTAGTTCAAATGCGGGTGC -> TTAGTTCAAATGCGGGTGCG
CTTCAGGTCTTGGTCCATTG -> TTCAGGTCTTGGTCCATTGG
CTTCCTTGAGGGAAATTAAA -> TTCCTTGAGGGAAATTAAAG
CTTGAGGGAAATTAAAGCGC -> TTGAGGGAAATTAAAGCGCT
CTTGCCCGAACCATCTGCAA -> TTGCCCGAACCATCTGCAAG
CTTGGACGTCTCACACGTTA -> TTGGACGTCTCACACGTTAT
CTTGGCAGAATCGTTGGCCG -> TTGGCAGAATCGTTGGCCGA
CTTGGTCCATTGGACATCGA -> TTGGTCCATTGGACATCGAC
CTTGTGCTATGGGGCCAGGG -> TTGTGCTATGGGGCCAGGGA
CTTTATGTTCCATCACATTG -> TTTATGTTCCATCACATTGG
GAAAAATCTTGCCCGAACCA -> AAAAATCTTGCCCGAACCAT
GAAACTTAACATTCGGTGGT -> AAACTTAACATTCGGTGGTA
GAAATTAAAGCGCTGCCTGG -> AAATTAAAGCGCTGCCTGGA
GAACAAGGCATCCTCAAGCC -> AACAAGGCATCCTCAAGCCT
GAACCATCTGCAAGGAAGGC -> AACCATCTGCAAGGAAGGCT
GAACGCCCTTACACAGGGGG -> AACGCCCTTACACAGGGGGG
GAACGTCTCCTGTTGCCAGT -> AACGTCTCCTGTTGCCAGTC
GAACTTGTGCTATGGGGCCA -> AACTTGTGCTATGGGGCCAG
GAAGAATGGCTACACTTCAG -> AAGAATGGCTACACTTCAGG
GAAGGCGTTTCGGGGTCCGC -> AAGGCGTTTCGGGGTCCGCG
GAAGGCTATAATCACCATCC -> AAGGCTATAATCACCATCCG
GAAGTTTTTAAGTTAGGTAA -> AAGTTTTTAAGTTAGGTAAT
GAATACGACGGTCTTAACTC -> AATACGACGGTCTTAACTCA
GAATCGTTGGCCGAGTGCGG -> AATCGTTGGCCGAGTGCGGA
GAATCTGTTGAACAAGGCAT -> AATCTGTTGAACAAGGCATC
GAATGGCTACACTTCAGGTC -> AATGGCTACACTTCAGGTCT
GAATTATAAAAAAGCCTATC -> AATTATAAAAAAGCCTATCT
GACAAAAGTAAACGTAGAGA -> ACAAAAGTAAACGTAGAGAA
GACAGGCACTGAAGAATGGC -> ACAGGCACTGAAGAATGGCT
GACAGGCCATATATGAAGGC -> ACAGGCCATATATGAAGGCG
GACATCGACCGCTGCCGAAT -> ACATCGACCGCTGCCGAATC
GACATGTGTCTGAGTTTCCT -> ACATGTGTCTGAGTTTCCTC
GACCGCTGCCGAATCTGTTG -> ACCGCTGCCGAATCTGTTGA
GACGCCCGTCGGTCACGATG -> ACGCCCGTCGGTCACGATGG
GACGGTCTTAACTCAAACCG -> ACGGTCTTAACTCAAACCGC
GACGTCTCACACGTTATGCC -> ACGTCTCACACGTTATGCCG
GACTGCAGTTCAAGTGAGAT -> ACTGCAGTTCAAGTGAGATG
GAGAAGTTTTTAAGTTAGGT -> AGAAGTTTTTAAGTTAGGTA
GAGATGAACGTCTCCTGTTG -> AGATGAACGTCTCCTGTTGC
GAGCACGATGCGTAACGATT -> AGCACGATGCGTAACGATTA
GAGCGACAGGCACTGAAGAA -> AGCGACAGGCACTGAAGAAT
GAGCGCTACGGAGTTGGATT -> AGCGCTACGGAGTTGGATTC
GAGGGAAATTAAAGCGCTGC -> AGGGAAATTAAAGCGCTGCC
GAGGTAGTGTCCCCGGCACG -> AGGTAGTGTCCCCGGCACGC
GAGTAACGTAAACTTGGACG -> AGTAACGTAAACTTGGACGT
GAGTGCGGAATTATAAAAAA -> AGTGCGGAATTATAAAAAAG
GAGTTGGATTCCGGTCAATC -> AGTTGGATTCCGGTCAATCT
GAGTTTCCTCTGGGAGCGCT -> AGTTTCCTCTGGGAGCGCTA
GATCACGCAAGCACCGACAA -> ATCACGCAAGCACCGACAAA
GATCCCCGCACCTAACGTCG -> ATCCCCGCACCTAACGTCGA
GATCTCGGATTGTCCCAGCT -> ATCTCGGATTGTCCCAGCTC
GATGAACGTCTCCTGTTGCC -> ATGAACGTCTCCTGTTGCCA
GATGCGCTCTGGACTGCAGT -> ATGCGCTCTGGACTGCAGTT
GATGCGTAACGATTAAACTG -> ATGCGTAACGATTAAACTGG
GATGGGTCATTTTCTAAATG -> ATGGGTCATTTTCTAAATGG
GATTAAACTGGCATATCGCC -> ATTAAACTGGCATATCGCCA
GATTCCGGTCAATCTATTTG -> ATTCCGGTCAATCTATTTGG
GATTCTTAGTTCAAATGCGG -> ATTCTTAGTTCAAATGCGGG
GATTGTCCCAGCTCGTGCTC -> ATTGTCCCAGCTCGTGCTCT
GATTTCACGGCCCTAGAAAC -> ATTTCACGGCCCTAGAAACT
GCAAGCACCGACAAAAGTAA -> CAAGCACCGACAAAAGTAAA
GCAAGGAAGGCTATAATCAC -> CAAGGAAGGCTATAATCACC
GCACCGACAAAAGTAAACGT -> CACCGACAAAAGTAAACGTA
GCACCTAACGTCGAGCACGA -> CACCTAACGTCGAGCACGAT
GCACGATGCGTAACGATTAA -> CACGATGCGTAACGATTAAA
GCACGCCCCGGATTCTTAGT -> CACGCCCCGGATTCTTAGTT
GCACTGAAGAATGGCTACAC -> CACTGAAGAATGGCTACACT
GCAGAATCGTTGGCCGAGTG -> CAGAATCGTTGGCCGAGTGC
GCAGGTTGGACAGGCCATAT -> CAGGTTGGACAGGCCATATA
GCAGTTCAAGTGAGATGAAC -> CAGTTCAAGTGAGATGAACG
GCATAGGCGCTGGCAGGTTG -> CATAGGCGCTGGCAGGTTGG
GCATATCGCCAACAATTCCA -> CATATCGCCAACAATTCCAC
GCATCCTCAAGCCTTTATGT -> CATCCTCAAGCCTTTATGTT
GCATTGATCACGCAAGCACC -> CATTGATCACGCAAGCACCG
GCCAACAATTCCACGGCCAT -> CCAACAATTCCACGGCCATG
GCCAATAGTCCGTAAACCGA -> CCAATAGTCCGTAAACCGAT
GCCAATGGAACGCCCTTACA -> CCAATGGAACGCCCTTACAC
GCCAGGGAATACGACGGTCT -> CCAGGGAATACGACGGTCTT
GCCAGTCTGGTGTAGGTGGC -> CCAGTCTGGTGTAGGTGGCC
GCCAGTTCGCGCCCCCATCC -> CCAGTTCGCGCCCCCATCCG
GCCATATATGAAGGCGTTTC -> CCATATATGAAGGCGTTTCG
GCCATGCCTTACAGCGCGAG -> CCATGCCTTACAGCGCGAGG
GCCCAGAGCGACAGGCACTG -> CCCAGAGCGACAGGCACTGA
GCCCCCATCCGTGTTGTGGA -> CCCCCATCCGTGTTGTGGAT
GCCCCGGATTCTTAGTTCAA -> CCCCGGATTCTTAGTTCAAA
GCCCGAACCATCTGCAAGGA -> CCCGAACCATCTGCAAGGAA
GCCCGTCGGTCACGATGGGT -> CCCGTCGGTCACGATGGGTC
GCCCTAGAAACTTAACATTC -> CCCTAGAAACTTAACATTCG
GCCCTTACACAGGGGGGGCC -> CCCTTACACAGGGGGGGCCC
GCCGAATCTGTTGAACAAGG -> CCGAATCTGTTGAACAAGGC
GCCGAGTGCGGAATTATAAA -> CCGAGTGCGGAATTATAAAA
GCCGCGCATAGGCGCTGGCA -> CCGCGCATAGGCGCTGGCAG
GCCGTGATTTCACGGCCCTA -> CCGTGATTTCACGGCCCTAG
GCCTACGCGTTCGCGCCAAT -> CCTACGCGTTCGCGCCAATA
GCCTATCTCCGATCTCGGAT -> CCTATCTCCGATCTCGGATT
GCCTCATCAGCATTGATCAC -> CCTCATCAGCATTGATCACG
GCCTGGAAAAATCTTGCCCG -> CCTGGAAAAATCTTGCCCGA
GCCTTACAGCGCGAGGTAGT -> CCTTACAGCGCGAGGTAGTG
GCCTTTATGTTCCATCACAT -> CCTTTATGTTCCATCACATT
GCGACAGGCACTGAAGAATG -> CGACAGGCACTGAAGAATGG
GCGACATGTGTCTGAGTTTC -> CGACATGTGTCTGAGTTTCC
GCGAGGTAGTGTCCCCGGCA -> CGAGGTAGTGTCCCCGGCAC
GCGCATAGGCGCTGGCAGGT -> CGCATAGGCGCTGGCAGGTT
GCGCCAATAGTCCGTAAACC -> CGCCAATAGTCCGTAAACCG
GCGCCAATGGAACGCCCTTA -> CGCCAATGGAACGCCCTTAC
GCGCCCCCATCCGTGTTGTG -> CGCCCCCATCCGTGTTGTGG
GCGCGAGGTAGTGTCCCCGG -> CGCGAGGTAGTGTCCCCGGC
GCGCTACGGAGTTGGATTCC -> CGCTACGGAGTTGGATTCCG
GCGCTCTGGACTGCAGTTCA -> CGCTCTGGACTGCAGTTCAA
GCGCTGCCTGGAAAAATCTT -> CGCTGCCTGGAAAAATCTTG
GCGCTGGCAGGTTGGACAGG -> CGCTGGCAGGTTGGACAGGC
GCGGAATTATAAAAAAGCCT -> CGGAATTATAAAAAAGCCTA
GCGGCCTACGCGTTCGCGCC -> CGGCCTACGCGTTCGCGCCA
GCGGGTGCGACATGTGTCTG -> CGGGTGCGACATGTGTCTGA
GCGTAACGATTAAACTGGCA -> CGTAACGATTAAACTGGCAT
GCGTCCAGGTCAAAATAGGT -> CGTCCAGGTCAAAATAGGTG
GCGTTCGCGCCAATAGTCCG -> CGTTCGCGCCAATAGTCCGT
GCGTTTCGGGGTCCGCGGCC -> CGTTTCGGGGTCCGCGGCCT
GCTACACTTCAGGTCTTGGT -> CTACACTTCAGGTCTTGGTC
GCTACGGAGTTGGATTCCGG -> CTACGGAGTTGGATTCCGGT
GCTATAATCACCATCCGACG -> CTATAATCACCATCCGACGC
GCTATATGCTCTTGGCAGAA -> CTATATGCTCTTGGCAGAAT
GCTATGGAGTAACGTAAACT -> CTATGGAGTAACGTAAACTT
GCTATGGGGCCAGGGAATAC -> CTATGGGGCCAGGGAATACG
GCTCGTGCTCTGGGCCGCGC -> CTCGTGCTCTGGGCCGCGCA
GCTCTGGACTGCAGTTCAAG -> CTCTGGACTGCAGTTCAAGT
GCTCTGGGCCGCGCATAGGC -> CTCTGGGCCGCGCATAGGCG
GCTCTTGGCAGAATCGTTGG -> CTCTTGGCAGAATCGTTGGC
GCTGCCGAATCTGTTGAACA -> CTGCCGAATCTGTTGAACAA
GCTGCCTGGAAAAATCTTGC -> CTGCCTGGAAAAATCTTGCC
GCTGGCAGGTTGGACAGGCC -> CTGGCAGGTTGGACAGGCCA
GGAAAAATCTTGCCCGAACC -> GAAAAATCTTGCCCGAACCA
GGAAATTAAAGCGCTGCCTG -> GAAATTAAAGCGCTGCCTGG
GGAACGCCCTTACACAGGGG -> GAACGCCCTTACACAGGGGG
GGAACTTGTGCTATGGGGCC -> GAACTTGTGCTATGGGGCCA
GGAAGGCTATAATCACCATC -> GAAGGCTATAATCACCATCC
GGAATACGACGGTCTTAACT -> GAATACGACGGTCTTAACTC
GGAATTATAAAAAAGCCTAT -> GAATTATAAAAAAGCCTATC
GGACAGGCCATATATGAAGG -> GACAGGCCATATATGAAGGC
GGACATCGACCGCTGCCGAA -> GACATCGACCGCTGCCGAAT
GGACGTCTCACACGTTATGC -> GACGTCTCACACGTTATGCC
GGACTGCAGTTCAAGTGAGA -> GACTGCAGTTCAAGTGAGAT
GGAGCGCTACGGAGTTGGAT -> GAGCGCTACGGAGTTGGATT
GGAGTAACGTAAACTTGGAC -> GAGTAACGTAAACTTGGACG
GGAGTTGGATTCCGGTCAAT -> GAGTTGGATTCCGGTCAATC
GGATCCCCGCACCTAACGTC -> GATCCCCGCACCTAACGTCG
GGATTCCGGTCAATCTATTT -> GATTCCGGTCAATCTATTTG
GGATTCTTAGTTCAAATGCG -> GATTCTTAGTTCAAATGCGG
GGATTGTCCCAGCTCGTGCT -> GATTGTCCCAGCTCGTGCTC
GGCACGCCCCGGATTCTTAG -> GCACGCCCCGGATTCTTAGT
GGCACTGAAGAATGGCTACA -> GCACTGAAGAATGGCTACAC
GGCAGAATCGTTGGCCGAGT -> GCAGAATCGTTGGCCGAGTG
GGCAGGTTGGACAGGCCATA -> GCAGGTTGGACAGGCCATAT
GGCATATCGCCAACAATTCC -> GCATATCGCCAACAATTCCA
GGCATCCTCAAGCCTTTATG -> GCATCCTCAAGCCTTTATGT
GGCCAGGGAATACGACGGTC -> GCCAGGGAATACGACGGTCT
GGCCAGTTCGCGCCCCCATC -> GCCAGTTCGCGCCCCCATCC
GGCCATATATGAAGGCGTTT -> GCCATATATGAAGGCGTTTC
GGCCATGCCTTACAGCGCGA -> GCCATGCCTTACAGCGCGAG
GGCCCAGAGCGACAGGCACT -> GCCCAGAGCGACAGGCACTG
GGCCCTAGAAACTTAACATT -> GCCCTAGAAACTTAACATTC
GGCCGAGTGCGGAATTATAA -> GCCGAGTGCGGAATTATAAA
GGCCGCGCATAGGCGCTGGC -> GCCGCGCATAGGCGCTGGCA
GGCCTACGCGTTCGCGCCAA -> GCCTACGCGTTCGCGCCAAT
GGCGCTGGCAGGTTGGACAG -> GCGCTGGCAGGTTGGACAGG
GGCGTCCAGGTCAAAATAGG -> GCGTCCAGGTCAAAATAGGT
GGCGTTTCGGGGTCCGCGGC -> GCGTTTCGGGGTCCGCGGCC
GGCTACACTTCAGGTCTTGG -> GCTACACTTCAGGTCTTGGT
GGCTATAATCACCATCCGAC -> GCTATAATCACCATCCGACG
GGCTATGGAGTAACGTAAAC -> GCTATGGAGTAACGTAAACT
GGGAAATTAAAGCGCTGCCT -> GGAAATTAAAGCGCTGCCTG
GGGAATACGACGGTCTTAAC -> GGAATACGACGGTCTTAACT
GGGAGCGCTACGGAGTTGGA -> GGAGCGCTACGGAGTTGGAT
GGGCCAGGGAATACGACGGT -> GGCCAGGGAATACGACGGTC
GGGCCCAGAGCGACAGGCAC -> GGCCCAGAGCGACAGGCACT
GGGCCGCGCATAGGCGCTGG -> GGCCGCGCATAGGCGCTGGC
GGGGCCAGGGAATACGACGG -> GGGCCAGGGAATACGACGGT
GGGGCCCAGAGCGACAGGCA -> GGGCCCAGAGCGACAGGCAC
GGGGGCCCAGAGCGACAGGC -> GGGGCCCAGAGCGACAGGCA
GGGGGGCCCAGAGCGACAGG -> GGGGGCCCAGAGCGACAGGC
GGGGGGGCCCAGAGCGACAG -> GGGGGGCCCAGAGCGACAGG
GGGGTCCGCGGCCTACGCGT -> GGGTCCGCGGCCTACGCGTT
GGGTCATTTTCTAAATGGGT -> GGTCATTTTCTAAATGGGTC
GGGTCCGCGGCCTACGCGTT -> GGTCCGCGGCCTACGCGTTC
GGGTCGGTCAAAGTCGCCTC -> GGTCGGTCAAAGTCGCCTCA
GGGTCTCAGGAACTTGTGCT -> GGTCTCAGGAACTTGTGCTA
GGGTGCGACATGTGTCTGAG -> GGTGCGACATGTGTCTGAGT
GGTAATCCGCGCCAATGGAA -> GTAATCCGCGCCAATGGAAC
GGTACAGCAGTTATAGTTGC -> GTACAGCAGTTATAGTTGCC
GGTAGTGTCCCCGGCACGCC -> GTAGTGTCCCCGGCACGCCC
GGTCAAAATAGGTGGGTCGG -> GTCAAAATAGGTGGGTCGGT
GGTCAAAGTCGCCTCATCAG -> GTCAAAGTCGCCTCATCAGC
GGTCAATCTATTTGGCGTCC -> GTCAATCTATTTGGCGTCCA
GGTCACGATGGGTCATTTTC -> GTCACGATGGGTCATTTTCT
GGTCATTTTCTAAATGGGTC -> GTCATTTTCTAAATGGGTCT
GGTCCATTGGACATCGACCG -> GTCCATTGGACATCGACCGC
GGTCCGCGGCCTACGCGTTC -> GTCCGCGGCCTACGCGTTCG
GGTCGGTCAAAGTCGCCTCA -> GTCGGTCAAAGTCGCCTCAT
GGTCTCAGGAACTTGTGCTA -> GTCTCAGGAACTTGTGCTAT
GGTCTTAACTCAAACCGCTA -> GTCTTAACTCAAACCGCTAT
GGTCTTGGTCCATTGGACAT -> GTCTTGGTCCATTGGACATC
GGTGCGACATGTGTCTGAGT -> GTGCGACATGTGTCTGAGTT
GGTGGCCAGTTCGCGCCCCC -> GTGGCCAGTTCGCGCCCCCA
GGTGGGTCGGTCAAAGTCGC -> GTGGGTCGGTCAAAGTCGCC
GGTGGTACAGCAGTTATAGT -> GTGGTACAGCAGTTATAGTT
GGTGGTTGTCCCAATACTTC -> GTGGTTGTCCCAATACTTCC
GGTGTAGGTGGCCAGTTCGC -> GTGTAGGTGGCCAGTTCGCG
GGTTGGACAGGCCATATATG -> GTTGGACAGGCCATATATGA
GGTTGTCCCAATACTTCCTT -> GTTGTCCCAATACTTCCTTG
GTAAACCGATGCGCTCTGGA -> TAAACCGATGCGCTCTGGAC
GTAAACGTAGAGAAGTTTTT -> TAAACGTAGAGAAGTTTTTA
GTAAACTTGGACGTCTCACA -> TAAACTTGGACGTCTCACAC
GTAACGATTAAACTGGCATA -> TAACGATTAAACTGGCATAT
GTAACGTAAACTTGGACGTC -> TAACGTAAACTTGGACGTCT
GTAATCCGCGCCAATGGAAC -> TAATCCGCGCCAATGGAACG
GTACAGCAGTTATAGTTGCC -> TACAGCAGTTATAGTTGCCT
GTAGAGAAGTTTTTAAGTTA -> TAGAGAAGTTTTTAAGTTAG
GTAGGTGGCCAGTTCGCGCC -> TAGGTGGCCAGTTCGCGCCC
GTAGTGTCCCCGGCACGCCC -> TAGTGTCCCCGGCACGCCCC
GTCAAAATAGGTGGGTCGGT -> TCAAAATAGGTGGGTCGGTC
GTCAAAGTCGCCTCATCAGC -> TCAAAGTCGCCTCATCAGCA
GTCAATCTATTTGGCGTCCA -> TCAATCTATTTGGCGTCCAG
GTCACGATGGGTCATTTTCT -> TCACGATGGGTCATTTTCTA
GTCATTTTCTAAATGGGTCT -> TCATTTTCTAAATGGGTCTC
GTCCAGGTCAAAATAGGTGG -> TCCAGGTCAAAATAGGTGGG
GTCCATTGGACATCGACCGC -> TCCATTGGACATCGACCGCT
GTCCCAATACTTCCTTGAGG -> TCCCAATACTTCCTTGAGGG
GTCCCAGCTCGTGCTCTGGG -> TCCCAGCTCGTGCTCTGGGC
GTCCCCGGCACGCCCCGGAT -> TCCCCGGCACGCCCCGGATT
GTCCGCGGCCTACGCGTTCG -> TCCGCGGCCTACGCGTTCGC
GTCCGTAAACCGATGCGCTC -> TCCGTAAACCGATGCGCTCT
GTCGAGCACGATGCGTAACG -> TCGAGCACGATGCGTAACGA
GTCGCCTCATCAGCATTGAT -> TCGCCTCATCAGCATTGATC
GTCGGTCAAAGTCGCCTCAT -> TCGGTCAAAGTCGCCTCATC
GTCGGTCACGATGGGTCATT -> TCGGTCACGATGGGTCATTT
GTCTCACACGTTATGCCGTG -> TCTCACACGTTATGCCGTGA
GTCTCAGGAACTTGTGCTAT -> TCTCAGGAACTTGTGCTATG
GTCTCCTGTTGCCAGTCTGG -> TCTCCTGTTGCCAGTCTGGT
GTCTGAGTTTCCTCTGGGAG -> TCTGAGTTTCCTCTGGGAGC
GTCTGGTGTAGGTGGCCAGT -> TCTGGTGTAGGTGGCCAGTT
GTCTTAACTCAAACCGCTAT -> TCTTAACTCAAACCGCTATA
GTCTTGGTCCATTGGACATC -> TCTTGGTCCATTGGACATCG
GTGAGATGAACGTCTCCTGT -> TGAGATGAACGTCTCCTGTT
GTGATTTCACGGCCCTAGAA -> TGATTTCACGGCCCTAGAAA
GTGCGACATGTGTCTGAGTT -> TGCGACATGTGTCTGAGTTT
GTGCGGAATTATAAAAAAGC -> TGCGGAATTATAAAAAAGCC
GTGCTATGGGGCCAGGGAAT -> TGCTATGGGGCCAGGGAATA
GTGCTCTGGGCCGCGCATAG -> TGCTCTGGGCCGCGCATAGG
GTGGATCCCCGCACCTAACG -> TGGATCCCCGCACCTAACGT
GTGGCCAGTTCGCGCCCCCA -> TGGCCAGTTCGCGCCCCCAT
GTGGGTCGGTCAAAGTCGCC -> TGGGTCGGTCAAAGTCGCCT
GTGGTACAGCAGTTATAGTT -> TGGTACAGCAGTTATAGTTG
GTGGTTGTCCCAATACTTCC -> TGGTTGTCCCAATACTTCCT
GTGTAGGTGGCCAGTTCGCG -> TGTAGGTGGCCAGTTCGCGC
GTGTCCCCGGCACGCCCCGG -> TGTCCCCGGCACGCCCCGGA
GTGTCTGAGTTTCCTCTGGG -> TGTCTGAGTTTCCTCTGGGA
GTGTTGTGGATCCCCGCACC -> TGTTGTGGATCCCCGCACCT
GTTAGGTAATCCGCGCCAAT -> TTAGGTAATCCGCGCCAATG
GTTATGCCGTGATTTCACGG -> TTATGCCGTGATTTCACGGC
GTTCAAATGCGGGTGCGACA -> TTCAAATGCGGGTGCGACAT
GTTCAAGTGAGATGAACGTC -> TTCAAGTGAGATGAACGTCT
GTTCCATCACATTGGCTATG -> TTCCATCACATTGGCTATGG
GTTCGCGCCAATAGTCCGTA -> TTCGCGCCAATAGTCCGTAA
GTTCGCGCCCCCATCCGTGT -> TTCGCGCCCCCATCCGTGTT
GTTGAACAAGGCATCCTCAA -> TTGAACAAGGCATCCTCAAG
GTTGCCAGTCTGGTGTAGGT -> TTGCCAGTCTGGTGTAGGTG
GTTGGACAGGCCATATATGA -> TTGGACAGGCCATATATGAA
GTTGGATTCCGGTCAATCTA -> TTGGATTCCGGTCAATCTAT
GTTGGCCGAGTGCGGAATTA -> TTGGCCGAGTGCGGAATTAT
GTTGTCCCAATACTTCCTTG -> TTGTCCCAATACTTCCTTGA
GTTGTGGATCCCCGCACCTA -> TTGTGGATCCCCGCACCTAA
GTTTCCTCTGGGAGCGCTAC -> TTTCCTCTGGGAGCGCTACG
GTTTCGGGGTCCGCGGCCTA -> TTTCGGGGTCCGCGGCCTAC
GTTTTTAAGTTAGGTAATCC -> TTTTTAAGTTAGGTAATCCG
TAAAAAAGCCTATCTCCGAT -> AAAAAAGCCTATCTCCGATC
TAAACCGATGCGCTCTGGAC -> AAACCGATGCGCTCTGGACT
TAAACGTAGAGAAGTTTTTA -> AAACGTAGAGAAGTTTTTAA
TAAACTGGCATATCGCCAAC -> AAACTGGCATATCGCCAACA
TAAACTTGGACGTCTCACAC -> AAACTTGGACGTCTCACACG
TAAAGCGCTGCCTGGAAAAA -> AAAGCGCTGCCTGGAAAAAT
TAAATGGGTCTCAGGAACTT -> AAATGGGTCTCAGGAACTTG
TAACATTCGGTGGTACAGCA -> AACATTCGGTGGTACAGCAG
TAACGATTAAACTGGCATAT -> AACGATTAAACTGGCATATC
TAACGTAAACTTGGACGTCT -> AACGTAAACTTGGACGTCTC
TAACGTCGAGCACGATGCGT -> AACGTCGAGCACGATGCGTA
TAACTCAAACCGCTATATGC -> AACTCAAACCGCTATATGCT
TAAGTTAGGTAATCCGCGCC -> AAGTTAGGTAATCCGCGCCA
TAATCACCATCCGACGCCCG -> AATCACCATCCGACGCCCGT
TAATCCGCGCCAATGGAACG -> AATCCGCGCCAATGGAACGC
TACACAGGGGGGGCCCAGAG -> ACACAGGGGGGGCCCAGAGC
TACACTTCAGGTCTTGGTCC -> ACACTTCAGGTCTTGGTCCA
TACAGCGCGAGGTAGTGTCC -> ACAGCGCGAGGTAGTGTCCC
TACGACGGTCTTAACTCAAA -> ACGACGGTCTTAACTCAAAC
TACGCGTTCGCGCCAATAGT -> ACGCGTTCGCGCCAATAGTC
TACGGAGTTGGATTCCGGTC -> ACGGAGTTGGATTCCGGTCA
TACTTCCTTGAGGGAAATTA -> ACTTCCTTGAGGGAAATTAA
TAGAAACTTAACATTCGGTG -> AGAAACTTAACATTCGGTGG
TAGAGAAGTTTTTAAGTTAG -> AGAGAAGTTTTTAAGTTAGG
TAGGCGCTGGCAGGTTGGAC -> AGGCGCTGGCAGGTTGGACA
TAGGTAATCCGCGCCAATGG -> AGGTAATCCGCGCCAATGGA
TAGGTGGCCAGTTCGCGCCC -> AGGTGGCCAGTTCGCGCCCC
TAGGTGGGTCGGTCAAAGTC -> AGGTGGGTCGGTCAAAGTCG
TAGTCCGTAAACCGATGCGC -> AGTCCGTAAACCGATGCGCT
TAGTGTCCCCGGCACGCCCC -> AGTGTCCCCGGCACGCCCCG
TAGTTCAAATGCGGGTGCGA -> AGTTCAAATGCGGGTGCGAC
TATAAAAAAGCCTATCTCCG -> ATAAAAAAGCCTATCTCCGA
TATAATCACCATCCGACGCC -> ATAATCACCATCCGACGCCC
TATATGAAGGCGTTTCGGGG -> ATATGAAGGCGTTTCGGGGT
TATATGCTCTTGGCAGAATC -> ATATGCTCTTGGCAGAATCG
TATCGCCAACAATTCCACGG -> ATCGCCAACAATTCCACGGC
TATCTCCGATCTCGGATTGT -> ATCTCCGATCTCGGATTGTC
TATGAAGGCGTTTCGGGGTC -> ATGAAGGCGTTTCGGGGTCC
TATGCCGTGATTTCACGGCC -> ATGCCGTGATTTCACGGCCC
TATGCTCTTGGCAGAATCGT -> ATGCTCTTGGCAGAATCGTT
TATGGAGTAACGTAAACTTG -> ATGGAGTAACGTAAACTTGG
TATGGGGCCAGGGAATACGA -> ATGGGGCCAGGGAATACGAC
TATGTTCCATCACATTGGCT -> ATGTTCCATCACATTGGCTA
TATTTGGCGTCCAGGTCAAA -> ATTTGGCGTCCAGGTCAAAA
TCAAAATAGGTGGGTCGGTC -> CAAAATAGGTGGGTCGGTCA
TCAAACCGCTATATGCTCTT -> CAAACCGCTATATGCTCTTG
TCAAAGTCGCCTCATCAGCA -> CAAAGTCGCCTCATCAGCAT
TCAAATGCGGGTGCGACATG -> CAAATGCGGGTGCGACATGT
TCAAGCCTTTATGTTCCATC -> CAAGCCTTTATGTTCCATCA
TCAAGTGAGATGAACGTCTC -> CAAGTGAGATGAACGTCTCC
TCAATCTATTTGGCGTCCAG -> CAATCTATTTGGCGTCCAGG
TCACACGTTATGCCGTGATT -> CACACGTTATGCCGTGATTT
TCACATTGGCTATGGAGTAA -> CACATTGGCTATGGAGTAAC
TCACCATCCGACGCCCGTCG -> CACCATCCGACGCCCGTCGG
TCACGATGGGTCATTTTCTA -> CACGATGGGTCATTTTCTAA
TCACGCAAGCACCGACAAAA -> CACGCAAGCACCGACAAAAG
TCACGGCCCTAGAAACTTAA -> CACGGCCCTAGAAACTTAAC
TCAGCATTGATCACGCAAGC -> CAGCATTGATCACGCAAGCA
TCAGGAACTTGTGCTATGGG -> CAGGAACTTGTGCTATGGGG
TCAGGTCTTGGTCCATTGGA -> CAGGTCTTGGTCCATTGGAC
TCATCAGCATTGATCACGCA -> CATCAGCATTGATCACGCAA
TCATTTTCTAAATGGGTCTC -> CATTTTCTAAATGGGTCTCA
TCCACGGCCATGCCTTACAG -> CCACGGCCATGCCTTACAGC
TCCAGGTCAAAATAGGTGGG -> CCAGGTCAAAATAGGTGGGT
TCCATCACATTGGCTATGGA -> CCATCACATTGGCTATGGAG
TCCATTGGACATCGACCGCT -> CCATTGGACATCGACCGCTG
TCCCAATACTTCCTTGAGGG -> CCCAATACTTCCTTGAGGGA
TCCCAGCTCGTGCTCTGGGC -> CCCAGCTCGTGCTCTGGGCC
TCCCCGCACCTAACGTCGAG -> CCCCGCACCTAACGTCGAGC
TCCCCGGCACGCCCCGGATT -> CCCCGGCACGCCCCGGATTC
TCCGACGCCCGTCGGTCACG -> CCGACGCCCGTCGGTCACGA
TCCGATCTCGGATTGTCCCA -> CCGATCTCGGATTGTCCCAG
TCCGCGCCAATGGAACGCCC -> CCGCGCCAATGGAACGCCCT
TCCGCGGCCTACGCGTTCGC -> CCGCGGCCTACGCGTTCGCG
TCCGGTCAATCTATTTGGCG -> CCGGTCAATCTATTTGGCGT
TCCGTAAACCGATGCGCTCT -> CCGTAAACCGATGCGCTCTG
TCCGTGTTGTGGATCCCCGC -> CCGTGTTGTGGATCCCCGCA
TCCTCAAGCCTTTATGTTCC -> CCTCAAGCCTTTATGTTCCA
TCCTCTGGGAGCGCTACGGA -> CCTCTGGGAGCGCTACGGAG
TCCTGTTGCCAGTCTGGTGT -> CCTGTTGCCAGTCTGGTGTA
TCCTTGAGGGAAATTAAAGC -> CCTTGAGGGAAATTAAAGCG
TCGACCGCTGCCGAATCTGT -> CGACCGCTGCCGAATCTGTT
TCGAGCACGATGCGTAACGA -> CGAGCACGATGCGTAACGAT
TCGCCAACAATTCCACGGCC -> CGCCAACAATTCCACGGCCA
TCGCCTCATCAGCATTGATC -> CGCCTCATCAGCATTGATCA
TCGCGCCAATAGTCCGTAAA -> CGCGCCAATAGTCCGTAAAC
TCGCGCCCCCATCCGTGTTG -> CGCGCCCCCATCCGTGTTGT
TCGGATTGTCCCAGCTCGTG -> CGGATTGTCCCAGCTCGTGC
TCGGGGTCCGCGGCCTACGC -> CGGGGTCCGCGGCCTACGCG
TCGGTCAAAGTCGCCTCATC -> CGGTCAAAGTCGCCTCATCA
TCGGTCACGATGGGTCATTT -> CGGTCACGATGGGTCATTTT
TCGGTGGTACAGCAGTTATA -> CGGTGGTACAGCAGTTATAG
TCGTGCTCTGGGCCGCGCAT -> CGTGCTCTGGGCCGCGCATA
TCGTTGGCCGAGTGCGGAAT -> CGTTGGCCGAGTGCGGAATT
TCTAAATGGGTCTCAGGAAC -> CTAAATGGGTCTCAGGAACT
TCTATTTGGCGTCCAGGTCA -> CTATTTGGCGTCCAGGTCAA
TCTCACACGTTATGCCGTGA -> CTCACACGTTATGCCGTGAT
TCTCAGGAACTTGTGCTATG -> CTCAGGAACTTGTGCTATGG
TCTCCGATCTCGGATTGTCC -> CTCCGATCTCGGATTGTCCC
TCTCCTGTTGCCAGTCTGGT -> CTCCTGTTGCCAGTCTGGTG
TCTCGGATTGTCCCAGCTCG -> CTCGGATTGTCCCAGCTCGT
TCTGAGTTTCCTCTGGGAGC -> CTGAGTTTCCTCTGGGAGCG
TCTGCAAGGAAGGCTATAAT -> CTGCAAGGAAGGCTATAATC
TCTGGACTGCAGTTCAAGTG -> CTGGACTGCAGTTCAAGTGA
TCTGGGAGCGCTACGGAGTT -> CTGGGAGCGCTACGGAGTTG
TCTGGGCCGCGCATAGGCGC -> CTGGGCCGCGCATAGGCGCT
TCTGGTGTAGGTGGCCAGTT -> CTGGTGTAGGTGGCCAGTTC
TCTGTTGAACAAGGCATCCT -> CTGTTGAACAAGGCATCCTC
TCTTAACTCAAACCGCTATA -> CTTAACTCAAACCGCTATAT
TCTTAGTTCAAATGCGGGTG -> CTTAGTTCAAATGCGGGTGC
TCTTGCCCGAACCATCTGCA -> CTTGCCCGAACCATCTGCAA
TCTTGGCAGAATCGTTGGCC -> CTTGGCAGAATCGTTGGCCG
TCTTGGTCCATTGGACATCG -> CTTGGTCCATTGGACATCGA
TGAACAAGGCATCCTCAAGC -> GAACAAGGCATCCTCAAGCC
TGAACGTCTCCTGTTGCCAG -> GAACGTCTCCTGTTGCCAGT
TGAAGAATGGCTACACTTCA -> GAAGAATGGCTACACTTCAG
TGAAGGCGTTTCGGGGTCCG -> GAAGGCGTTTCGGGGTCCGC
TGAGATGAACGTCTCCTGTT -> GAGATGAACGTCTCCTGTTG
TGAGGGAAATTAAAGCGCTG -> GAGGGAAATTAAAGCGCTGC
TGAGTTTCCTCTGGGAGCGC -> GAGTTTCCTCTGGGAGCGCT
TGATCACGCAAGCACCGACA -> GATCACGCAAGCACCGACAA
TGATTTCACGGCCCTAGAAA -> GATTTCACGGCCCTAGAAAC
TGCAAGGAAGGCTATAATCA -> GCAAGGAAGGCTATAATCAC
TGCAGTTCAAGTGAGATGAA -> GCAGTTCAAGTGAGATGAAC
TGCCAGTCTGGTGTAGGTGG -> GCCAGTCTGGTGTAGGTGGC
TGCCCGAACCATCTGCAAGG -> GCCCGAACCATCTGCAAGGA
TGCCGAATCTGTTGAACAAG -> GCCGAATCTGTTGAACAAGG
TGCCGTGATTTCACGGCCCT -> GCCGTGATTTCACGGCCCTA
TGCCTGGAAAAATCTTGCCC -> GCCTGGAAAAATCTTGCCCG
TGCCTTACAGCGCGAGGTAG -> GCCTTACAGCGCGAGGTAGT
TGCGACATGTGTCTGAGTTT -> GCGACATGTGTCTGAGTTTC
TGCGCTCTGGACTGCAGTTC -> GCGCTCTGGACTGCAGTTCA
TGCGGAATTATAAAAAAGCC -> GCGGAATTATAAAAAAGCCT
TGCGGGTGCGACATGTGTCT -> GCGGGTGCGACATGTGTCTG
TGCGTAACGATTAAACTGGC -> GCGTAACGATTAAACTGGCA
TGCTATGGGGCCAGGGAATA -> GCTATGGGGCCAGGGAATAC
TGCTCTGGGCCGCGCATAGG -> GCTCTGGGCCGCGCATAGGC
TGCTCTTGGCAGAATCGTTG -> GCTCTTGGCAGAATCGTTGG
TGGAAAAATCTTGCCCGAAC -> GGAAAAATCTTGCCCGAACC
TGGAACGCCCTTACACAGGG -> GGAACGCCCTTACACAGGGG
TGGACAGGCCATATATGAAG -> GGACAGGCCATATATGAAGG
TGGACATCGACCGCTGCCGA -> GGACATCGACCGCTGCCGAA
TGGACGTCTCACACGTTATG -> GGACGTCTCACACGTTATGC
TGGACTGCAGTTCAAGTGAG -> GGACTGCAGTTCAAGTGAGA
TGGAGTAACGTAAACTTGGA -> GGAGTAACGTAAACTTGGAC
TGGATCCCCGCACCTAACGT -> GGATCCCCGCACCTAACGTC
TGGATTCCGGTCAATCTATT -> GGATTCCGGTCAATCTATTT
TGGCAGAATCGTTGGCCGAG -> GGCAGAATCGTTGGCCGAGT
TGGCAGGTTGGACAGGCCAT -> GGCAGGTTGGACAGGCCATA
TGGCATATCGCCAACAATTC -> GGCATATCGCCAACAATTCC
TGGCCAGTTCGCGCCCCCAT -> GGCCAGTTCGCGCCCCCATC
TGGCCGAGTGCGGAATTATA -> GGCCGAGTGCGGAATTATAA
TGGCGTCCAGGTCAAAATAG -> GGCGTCCAGGTCAAAATAGG
TGGCTACACTTCAGGTCTTG -> GGCTACACTTCAGGTCTTGG
TGGCTATGGAGTAACGTAAA -> GGCTATGGAGTAACGTAAAC
TGGGAGCGCTACGGAGTTGG -> GGGAGCGCTACGGAGTTGGA
TGGGCCGCGCATAGGCGCTG -> GGGCCGCGCATAGGCGCTGG
TGGGGCCAGGGAATACGACG -> GGGGCCAGGGAATACGACGG
TGGGTCATTTTCTAAATGGG -> GGGTCATTTTCTAAATGGGT
TGGGTCGGTCAAAGTCGCCT -> GGGTCGGTCAAAGTCGCCTC
TGGGTCTCAGGAACTTGTGC -> GGGTCTCAGGAACTTGTGCT
TGGTACAGCAGTTATAGTTG -> GGTACAGCAGTTATAGTTGC
TGGTCCATTGGACATCGACC -> GGTCCATTGGACATCGACCG
TGGTGTAGGTGGCCAGTTCG -> GGTGTAGGTGGCCAGTTCGC
TGGTTGTCCCAATACTTCCT -> GGTTGTCCCAATACTTCCTT
TGTAGGTGGCCAGTTCGCGC -> GTAGGTGGCCAGTTCGCGCC
TGTCCCAATACTTCCTTGAG -> GTCCCAATACTTCCTTGAGG
TGTCCCAGCTCGTGCTCTGG -> GTCCCAGCTCGTGCTCTGGG
TGTCCCCGGCACGCCCCGGA -> GTCCCCGGCACGCCCCGGAT
TGTCTGAGTTTCCTCTGGGA -> GTCTGAGTTTCCTCTGGGAG
TGTGCTATGGGGCCAGGGAA -> GTGCTATGGGGCCAGGGAAT
TGTGGATCCCCGCACCTAAC -> GTGGATCCCCGCACCTAACG
TGTGTCTGAGTTTCCTCTGG -> GTGTCTGAGTTTCCTCTGGG
TGTTCCATCACATTGGCTAT -> GTTCCATCACATTGGCTATG
TGTTGAACAAGGCATCCTCA -> GTTGAACAAGGCATCCTCAA
TGTTGCCAGTCTGGTGTAGG -> GTTGCCAGTCTGGTGTAGGT
TGTTGTGGATCCCCGCACCT -> GTTGTGGATCCCCGCACCTA
TTAAACTGGCATATCGCCAA -> TAAACTGGCATATCGCCAAC
TTAAAGCGCTGCCTGGAAAA -> TAAAGCGCTGCCTGGAAAAA
TTAACATTCGGTGGTACAGC -> TAACATTCGGTGGTACAGCA
TTAACTCAAACCGCTATATG -> TAACTCAAACCGCTATATGC
TTAAGTTAGGTAATCCGCGC -> TAAGTTAGGTAATCCGCGCC
TTACACAGGGGGGGCCCAGA -> TACACAGGGGGGGCCCAGAG
TTACAGCGCGAGGTAGTGTC -> TACAGCGCGAGGTAGTGTCC
TTAGGTAATCCGCGCCAATG -> TAGGTAATCCGCGCCAATGG
TTAGTTCAAATGCGGGTGCG -> TAGTTCAAATGCGGGTGCGA
TTATAAAAAAGCCTATCTCC -> TATAAAAAAGCCTATCTCCG
TTATGCCGTGATTTCACGGC -> TATGCCGTGATTTCACGGCC
TTATGTTCCATCACATTGGC -> TATGTTCCATCACATTGGCT
TTCAAATGCGGGTGCGACAT -> TCAAATGCGGGTGCGACATG
TTCAAGTGAGATGAACGTCT -> TCAAGTGAGATGAACGTCTC
TTCACGGCCCTAGAAACTTA -> TCACGGCCCTAGAAACTTAA
TTCAGGTCTTGGTCCATTGG -> TCAGGTCTTGGTCCATTGGA
TTCCACGGCCATGCCTTACA -> TCCACGGCCATGCCTTACAG
TTCCATCACATTGGCTATGG -> TCCATCACATTGGCTATGGA
TTCCGGTCAATCTATTTGGC -> TCCGGTCAATCTATTTGGCG
TTCCTCTGGGAGCGCTACGG -> TCCTCTGGGAGCGCTACGGA
TTCCTTGAGGGAAATTAAAG -> TCCTTGAGGGAAATTAAAGC
TTCGCGCCAATAGTCCGTAA -> TCGCGCCAATAGTCCGTAAA
TTCGCGCCCCCATCCGTGTT -> TCGCGCCCCCATCCGTGTTG
TTCGGGGTCCGCGGCCTACG -> TCGGGGTCCGCGGCCTACGC
TTCGGTGGTACAGCAGTTAT -> TCGGTGGTACAGCAGTTATA
TTCTAAATGGGTCTCAGGAA -> TCTAAATGGGTCTCAGGAAC
TTCTTAGTTCAAATGCGGGT -> TCTTAGTTCAAATGCGGGTG
TTGAACAAGGCATCCTCAAG -> TGAACAAGGCATCCTCAAGC
TTGAGGGAAATTAAAGCGCT -> TGAGGGAAATTAAAGCGCTG
TTGATCACGCAAGCACCGAC -> TGATCACGCAAGCACCGACA
TTGCCAGTCTGGTGTAGGTG -> TGCCAGTCTGGTGTAGGTGG
TTGCCCGAACCATCTGCAAG -> TGCCCGAACCATCTGCAAGG
TTGGACAGGCCATATATGAA -> TGGACAGGCCATATATGAAG
TTGGACATCGACCGCTGCCG -> TGGACATCGACCGCTGCCGA
TTGGACGTCTCACACGTTAT -> TGGACGTCTCACACGTTATG
TTGGATTCCGGTCAATCTAT -> TGGATTCCGGTCAATCTATT
TTGGCAGAATCGTTGGCCGA -> TGGCAGAATCGTTGGCCGAG
TTGGCCGAGTGCGGAATTAT -> TGGCCGAGTGCGGAATTATA
TTGGCGTCCAGGTCAAAATA -> TGGCGTCCAGGTCAAAATAG
TTGGCTATGGAGTAACGTAA -> TGGCTATGGAGTAACGTAAA
TTGGTCCATTGGACATCGAC -> TGGTCCATTGGACATCGACC
TTGTCCCAATACTTCCTTGA -> TGTCCCAATACTTCCTTGAG
TTGTCCCAGCTCGTGCTCTG -> TGTCCCAGCTCGTGCTCTGG
TTGTGCTATGGGGCCAGGGA -> TGTGCTATGGGGCCAGGGAA
TTGTGGATCCCCGCACCTAA -> TGTGGATCCCCGCACCTAAC
TTTAAGTTAGGTAATCCGCG -> TTAAGTTAGGTAATCCGCGC
TTTATGTTCCATCACATTGG -> TTATGTTCCATCACATTGGC
TTTCACGGCCCTAGAAACTT -> TTCACGGCCCTAGAAACTTA
TTTCCTCTGGGAGCGCTACG -> TTCCTCTGGGAGCGCTACGG
TTTCGGGGTCCGCGGCCTAC -> TTCGGGGTCCGCGGCCTACG
TTTCTAAATGGGTCTCAGGA -> TTCTAAATGGGTCTCAGGAA
TTTGGCGTCCAGGTCAAAAT -> TTGGCGTCCAGGTCAAAATA
TTTTAAGTTAGGTAATCCGC -> TTTAAGTTAGGTAATCCGCG
TTTTCTAAATGGGTCTCAGG -> TTTCTAAATGGGTCTCAGGA
TTTTTAAGTTAGGTAATCCG -> TTTTAAGTTAGGTAATCCGC
